    1    2    8   11   18   23   24   31   35   37   39   41   48   52   60   66   68   76   81   84   87   90   98  103  112  119  122  131  137  141  145  149  158  164  165  173  177  178  185  190  195  200  201  208  210  219  224  226  234  240
    2    5   13   12   15   22   25   31   38   39   41   45   54   54   58   66   70   77   85   87   90   95   96   99  104  113  118  126  135  139  143  149  151  155  161  162  168  177  178  183  188  195  198  203  210  212  219  220  222  228
    4    5    8   14   19   20   21   24   26   34   37   39   43   50   56   58   60   64   67   76   80   83   88   96  103  106  109  114  118  119  124  128  134  143  151  155  159  165  170  172  178  183  190  191  200  205  210  217  223  226
    7   11   17   18   27   23   22   27   32   41   41   46   44   49   50   54   56   62   69   70   75   83   85   91   93   98  101  108  116  118  124  133  136  143  146  152  156  164  173  175  182  183  187  195  199  206  211  220  221  225
   14   15   21   21   25   24   29   28   29   30   38   43   50   53   55   56   64   64   66   68   77   83   91   96   99  101  110  111  114  117  118  125  134  140  147  151  152  156  160  164  166  174  175  182  190  195  197  202  207  212
   15   18   19   28   26   26   34   29   32   37   39   43   45   46   48   51   60   62   66   74   77   82   85   87   90   94   95   98  103  112  116  122  126  129  133  138  140  144  150  151  156  163  168  172  177  183  186  191  198  200
   16   19   24   33   35   27   29   33   34   35   37   41   47   47   48   50   53   58   61   63   66   71   78   80   82   85   89   95   99  102  106  112  120  123  126  130  135  142  147  151  156  163  172  176  180  185  191  199  204  205
   19   20   22   27   31   29   30   36   37   44   41   43   46   52   53   53   55   62   65   64   69   72   76   83   88   89   92  100  104  104  110  114  119  127  133  135  139  148  153  154  161  166  172  181  188  191  196  197  204  208
   20   22   31   30   31   32   38   41   39   40   42   45   46   50   52   56   64   68   68   66   69   73   75   80   83   88   89   96  100  103  107  112  115  121  125  131  133  141  146  150  155  161  165  172  177  184  187  196  202  207
   22   25   26   27   36   36   40   45   47   41   44   48   48   50   51   56   61   67   76   68   72   77   78   81   83   89   95  102  101  104  109  115  119  123  126  133  140  148  148  152  158  165  170  175  179  187  195  204  205  210
   24   26   33   31   39   42   42   50   52   44   47   50   56   55   60   63   64   73   79   72   76   80   87   87   84   92   96   97  104  109  114  119  120  127  128  137  142  144  152  158  164  170  172  180  182  183  189  192  201  208
   26   30   39   33   37   45   46   53   60   47   50   55   56   58   63   72   69   77   86   76   80   86   88   91   90   91   97  106  105  110  115  122  123  128  135  137  144  145  147  153  159  167  171  177  185  186  194  194  197  204
   29   31   35   40   43   45   47   51   54   56   54   57   61   66   70   73   72   77   81   77   82   86   92  100   98   95   99  105  110  112  118  123  130  129  138  142  147  152  153  156  163  169  177  179  180  186  192  200  204  208
   33   38   36   41   42   46   48   54   61   57   59   65   63   69   71   76   75   82   89   79   85   94   95  102  101  101  103  111  119  115  122  123  127  135  139  146  151  160  154  158  166  168  173  182  185  193  198  199  201  206
   41   43   43   45   47   48   56   56   58   59   68   71   71   74   77   79   84   85   88   82   83   90   99  105  108  105  104  108  112  116  118  126  127  134  142  147  149  154  159  163  166  175  175  183  192  198  201  205  207  212
   43   47   45   46   48   51   60   58   62   67   70   75   74   76   79   83   84   87   92   91   87   93   97  100  104  109  106  110  116  117  122  129  132  136  141  147  150  155  162  164  170  178  181  186  192  199  203  209  215  215
   45   49   51   47   48   50   53   58   61   63   66   71   78   78   80   83   87   93   96   94   91   97  105  103  106  110  111  117  121  121  126  133  141  140  144  149  155  163  168  169  175  183  182  187  192  198  205  214  221  221
   49   51   54   53   53   53   55   62   65   64   69   72   76   83   86   87   90   98  101   96   97  101  106  111  113  115  115  124  127  124  131  136  142  149  152  155  160  161  168  172  180  186  189  188  197  204  210  212  220  225
   51   54   55   57   55   57   64   68   68   66   69   73   75   80   83   88   89   96  100   99  101  106  109  115  117  121  117  125  130  128  133  139  143  150  155  162  163  170  174  177  183  190  194  196  202  210  214  213  220  226
   54   58   57   59   56   61   66   72   77   68   72   77   78   81   83   89   95  102  101  102  106  112  113  117  120  127  124  132  132  132  138  145  148  153  157  165  171  179  177  182  189  197  200  202  207  216  223  214  218  224
   57   60   65   64   65   68   69   78   83   72   76   80   87   87   84   92   96   97  104  107  111  116  114  121  122  131  129  131  139  138  144  150  150  158  160  161  167  170  179  186  193  200  203  211  211  213  220  218  219  227
   60   65   66   67   70   77   74   82   91   76   80   86   88   91   90   91   97  106  105  110  115  122  117  122  129  131  136  132  134  140  146  154  154  160  168  164  172  172  175  182  189  198  203  210  219  217  226  221  223  231
   64   67   71   75   77   80   77   82   86   77   82   86   92  100   98   95   99  105  110  112  118  123  124  123  132  136  141  139  140  143  150  156  162  162  163  169  175  180  182  186  194  201  210  213  215  222  229  230  231  236
   69   75   73   79   79   84   80   87   94   79   85   94   95  102  101  101  103  111  119  115  122  123  127  131  135  142  146  148  141  145  153  155  160  169  168  176  181  181  183  188  197  200  206  207  213  222  229  231  234  240
   78   81   81   84   85   87   89   90   93   82   83   90   99  105  108  105  104  108  112  116  118  126  127  134  142  147  148  153  146  150  153  162  162  170  177  182  184  187  189  194  198  199  202  211  212  219  223  230  237  244
   81   86   84   86   88   91   90   93   98   91   87   93   97  100  104  109  106  110  116  117  122  129  132  136  141  147  150  155  153  152  158  166  168  173  179  186  188  193  197  197  204  208  209  215  219  227  228  235  244  248
   84   89   91   88   90   93   94   99  102   94   91   97  105  103  106  110  111  117  121  121  126  133  141  140  144  149  155  163  159  157  163  171  169  174  179  185  192  201  204  203  210  217  211  217  223  230  236  236  244  251
   89   92   95   95   96   97   97  105  107   96   97  101  106  111  113  115  115  124  127  124  131  136  142  149  152  155  160  161  166  161  169  175  176  175  184  191  197  199  207  208  217  224  219  219  220  228  235  238  247  253
   92   96   97  100   99  102   98  105  109   99  101  106  109  115  117  121  117  125  130  128  133  139  143  150  155  162  163  170  172  166  172  179  181  183  189  197  201  200  207  213  220  228  225  228  227  236  240  240  248  255
   96  101  100  103  101  107  104  111  110  102  106  112  113  117  120  127  124  132  132  132  138  145  148  153  157  165  171  179  175  171  178  186  187  189  194  203  210  201  205  211  219  228  232  235  233  234  235  237  242  249
  100  104  109  109  102  110  108  109  116  107  111  116  114  121  122  131  129  131  139  138  144  150  150  158  160  161  167  170  179  178  185  192  190  198  198  200  207  205  206  214  222  230  234  235  238  237  243  242  244  253
  104  110  111  113  108  109  114  118  117  112  116  123  117  122  129  131  136  132  134  140  146  154  154  160  168  164  172  172  175  182  189  198  195  202  207  204  213  208  210  218  226  227  233  241  239  242  243  246  249  258
  109  113  117  122  116  113  117  123  122  114  120  125  124  123  132  136  141  139  140  143  150  156  162  162  163  169  175  180  182  186  194  201  204  205  207  211  218  217  218  223  232  235  234  238  241  249  251  247  256  262
  115  122  120  127  119  119  121  129  131  117  124  125  128  131  135  142  146  148  141  145  153  155  160  169  168  176  181  181  183  188  197  200  206  206  212  220  225  219  221  227  228  232  239  240  247  248  256  250  254  261
  116  123  129  133  126  123  122  126  130  121  123  131  129  136  143  147  148  153  146  150  153  162  162  170  177  182  184  187  189  194  198  199  202  211  212  219  223  226  228  234  233  234  238  239  241  249  254  258  262  269
  120  126  130  133  130  128  124  128  134  122  127  134  134  138  143  149  151  156  153  152  158  166  168  173  179  186  188  193  197  197  204  208  209  215  219  227  228  233  237  238  241  235  243  246  249  258  260  266  263  268
  124  130  138  136  133  132  129  135  139  126  131  138  143  142  146  151  157  164  159  157  163  171  169  174  179  185  192  201  204  203  210  217  211  217  223  230  236  234  242  245  249  236  239  246  253  261  269  268  272  276
  130  134  139  144  140  137  133  142  145  129  136  141  147  151  154  157  162  163  166  161  169  175  176  175  184  191  197  199  207  208  217  224  219  219  220  228  235  237  246  251  250  244  248  249  251  260  268  272  273  280
  134  139  142  148  144  143  135  143  148  133  138  144  148  155  159  164  165  172  172  166  172  179  181  183  189  197  201  200  207  213  220  228  225  228  227  236  240  239  247  254  258  253  255  250  258  259  265  268  277  285
  139  145  146  150  147  150  142  150  150  137  143  150  153  158  162  170  173  181  175  171  178  186  187  189  194  203  210  201  205  211  219  228  232  235  233  234  235  237  242  249  258  254  262  258  265  261  263  266  272  280
  144  149  147  154  149  158  147  149  157  143  149  155  155  163  165  166  172  175  184  178  185  192  190  198  198  200  207  205  206  214  222  230  234  235  238  237  243  242  244  253  262  263  267  260  266  265  272  272  275  276
  149  156  150  155  156  158  154  150  152  149  155  163  159  165  173  169  177  177  180  185  192  201  195  202  207  204  213  208  210  218  226  227  233  241  239  242  243  246  249  258  267  265  272  269  268  271  273  277  281  277
  155  160  157  156  165  163  159  157  158  152  159  165  167  167  168  174  180  185  187  189  197  204  204  205  207  211  218  217  218  223  232  235  234  238  241  249  251  247  256  262  263  272  274  274  272  280  282  279  280  284
  162  161  161  164  168  170  164  166  159  156  164  166  171  176  173  181  186  186  188  193  202  205  210  206  212  220  225  219  221  227  228  232  239  240  247  248  256  250  254  261  263  268  276  277  280  282  291  283  285  292
  164  169  162  169  176  175  166  171  164  161  164  173  173  181  182  187  189  192  194  199  203  204  207  215  213  220  224  226  228  234  233  234  238  239  241  249  254  258  262  269  269  271  276  278  281  290  296  292  294  301
  169  176  167  171  176  181  169  174  171  163  169  177  179  184  188  194  193  198  202  202  209  213  214  220  220  228  229  233  237  238  241  235  243  246  249  258  260  266  263  268  277  273  282  286  290  291  298  301  296  302
  174  181  176  175  179  184  175  182  177  168  174  182  180  185  190  196  200  207  209  208  215  222  216  222  226  233  237  234  242  245  249  236  239  246  253  261  269  268  272  276  285  275  279  287  295  300  299  302  297  306
  181  186  182  184  187  190  180  181  184  172  180  186  187  186  195  202  206  208  216  213  222  229  224  224  225  233  240  237  246  251  250  244  248  249  251  260  268  272  273  280  282  284  280  284  287  288  297  302  299  307
  186  192  186  191  192  197  183  190  190  177  183  190  192  194  200  208  210  209  216  219  226  234  230  233  232  241  245  239  247  254  258  253  255  250  258  259  265  268  277  285  291  285  288  286  295  290  297  301  300  309
  192  199  191  196  196  204  191  199  193  182  189  197  198  200  205  214  219  210  214  220  228  237  237  240  238  239  240  241  246  253  262  254  262  258  265  261  263  266  272  280  281  283  292  295  303  293  296  300  307  316
15b = 315
